[31m ~    ~                   ~~          ~          ~~~~~                     ~~~                          
 ~    ~                    ~          ~            ~                      ~   ~                         
 ~    ~   ~~~~   ~ ~~~     ~      ~~~~~            ~      ~~~~           ~        ~~~~   ~~ ~     ~~~~  
 ~    ~  ~    ~  ~~        ~     ~    ~            ~     ~    ~          ~       ~    ~  ~ ~ ~   ~    ~ 
 ~ ~~ ~  ~    ~  ~         ~     ~    ~            ~     ~    ~          ~       ~    ~  ~ ~ ~   ~~~~~~ 
 ~~  ~~  ~    ~  ~         ~     ~    ~            ~     ~    ~           ~   ~  ~    ~  ~ ~ ~   ~      
 ~    ~   ~~~~   ~        ~~~     ~~~~~            ~      ~~~~             ~~~    ~~~~   ~   ~    ~~~~  
                                                                                                        
